KÜREK: BİRİ KARADA BİRİ DENİZDE KULLANILAN İKİ AYRI EL ALETİNİN ORTAK ADI
PEREST: “TAPAN, HİZMET EDEN” ANLAMI TAŞIYAN BİLEŞİK KELİMELERDE KULLANILAN FARSÇA KÖKENLİ SÖZ
ŞAŞMAMAK: MECAZEN YOLUNDAN SAPMAMAK, YÖNTEMİNİ TERCİHİNİ DEĞİŞTİRMEMEK 
ELDENELE: MİNİBÜSLERDE TAŞIMA ÜCRETİNİ ŞOFÖRE ULAŞTIRMAK İÇİN KULLANILAN BİR YÖNTEM
EŞİTLEMEK: İKİ VEYA DAHA FAZLA ÖGEYİ NİCELİK VE NİTELİK BAKIMINDAN AYNI DÜZEYE GETİRMEK 
NANEŞEKERİ: FERAHLIK SAĞLADIĞI İÇİN ARAÇ TUTMALARINA KARŞI DA KULLANILAN AĞIR TATLANDIRICI
İVME: HIZDA OLUŞAN DEĞİŞİMİN ZAMANA ORANI 
SERİ: FAİLİ AYNI KİŞİ OLAN BİR DİZİ CİNAYETİ NİTELERKEN KULLANILAN SÖZ
AÇLIK: MECAZİ ANLAMDA YOKSUNLUK VE AŞIRI İSTEK İÇİNDE BULUNMA DURUMU
FERSAH: YAKLAŞIK 5 KİLOMETRELİK ESKİ BİR UZUNLUK ÖLÇÜSÜ
ARALIK: GÜNEY YARINKÜRENİN BİRÇOK BÖLÜMÜNÜN YAZ MEVSİMİNE GİRDİĞİ AY 
KANNAKLİ: HEMATOLOJİK TRANSFER
UĞURLAMAK: GİDENİ ESENLİK VE SEVGİ DİLEKLERİYLE GEÇİRMEK, YOLCU ETMEK
OPAK: DONUK VE MAT RENK TONLARINI NİTELEYEN YABANCI KÖKENLİ BİR SIFAT
KIRIK: ALINAN DÜŞÜK NOTLARIN KARNEDEKİ YANSIMASI
ESİRKAMPI: ELE GEÇİRİLMİŞ DÜŞMANLARIN GÖZETİM ALTINDA BULUNDURULDUĞU YER 
YATAKODASI: ADETLERE GÖRE KURULUM AŞAMASINDAKİ DÜNYAEVİNİN KIZ TARAFININ YÜKÜMLÜLÜĞÜNDE OLAN ALANI
TOPLUKONUT: NİSPETEN KÜÇÜK BİR ALANDA BİRÇOK KİŞİNİN BARINMASI İÇİN İNŞA EDİLEN BİNALAR BÜTÜNÜ
ZEYTİNDALI: EVRENSEL BARIŞ SEMBOLÜ,
NARSİST: BEN SEVDALISI
FORMALİTE: ÖNEM VERİLMEDİĞİ HALDE BİR ZORUNLULUĞA BAĞLI OLARAK YAPĞILAN BİÇİMSEL DAVRANIŞ
DAHA: HENÜZ VEYA BUNUN DIŞINDA ANLAMLARINDA KULLANILAN BİR SÖZ
MURAT: GERÇEKLEŞTİRMEK İÇİN TASARLANANAN VE ERİŞMEK İSTENİLEN DİLEK 
SAĞMAL: BOL SÜT VEREN HAYVANLAR İÇİN KULLANILAN BİR SÖZ
SELEKTÖR: OTOMOBİLDE FARLARIN UZUN VE KISA UZAKLIKTA YANSIMASINI SAĞLAYAN ARAÇ
SÜRÜNMEK: MECAZEN YOKSULLUK VE PERİŞANLIM İÇİN YAŞAMAK
ŞNORKEL: YÜZÜCÜLER İÇİN HARİCİ SOLUK BORUSU
ÖDEV: YAPMAYA, YERİNE GETİRMEYE YÜKÜMLÜ OLUNAN ŞEY
MEDET: “YARDIM EDİN, İMDAT” ANLAMINDA BİR SESLENME SÖZÜ OLARAK DA KULLANILAN ARAPÇA KÖKENLİ BİR SÖZ
SİLGİ: GENELLİKLE BİTMEDEN KAYBEDİLEN BİR KIRTASİYE MALZEMESİ
AKARET: KİRA GELİRİ GETİREN MÜLK
KAPSAM: SINIRLARI İÇİNE BAŞKA KONULARI VEYA ANLAMLARI ALMA DURUMU
HARÇLIK: UFAK TEFEK GEREKSİNİMLER İÇİN KULLANILAN PARA HAMMADDE BİR ÜRÜN VEYA MAL OLUŞTURMAK İÇİN GEREKLİ NESNELERİN İŞLENMEDEN ÖNCEKİ DOĞAL DURUMU
BUĞULAMA: SU BUHARIYLA YİYECEK HAZIRLAMA
LAFDALAŞI: SÖZLERLE YAPILAN KAVGA
TEŞRİFETME: VARLIĞIYLA, ZİYARETİYLE BİR YERİ ONURLANDIRMA, ŞEREFLENDİRME
HÜCUMMETMEK: ATAK YAPMAK, SALDIRMAK
ÇITA: MİNYATÜR KERESTE
ÖDEM: HÜCRELER ARASI SIVIDA NORMALDEN FAZLA MİKTARDA SU TOPLANMASI
SAYFA: YAZI YAZMAK İÇİN KULLANILAN KAĞIT YAPRAĞININ HER İKİ YÜZÜNDEN BİRİ
PUNTO: BASIMCILIKTA HARFLERİN BÜYÜKLÜK VE KÜÇÜKLÜKLERİNE GÖRE ALDIĞI AD
BUHRAN: BUNALIM, KRİZ ANLAMINDA YABANCI BİR SÖZ
AHALMAK: BİRİNE ZARAR VEREREK BEDDUASINI ÜZERİNE ÇEKMEK
ANAERKİL: MATRİARKAL VEYA MADERŞAHİ DE DENİLEN TOPLUM DÜZENİ
DEPRESYON: RUH VE HAYAT ENEJİSİNDE YAŞANAN DARALMA
HOKUSPOKUS: SİHİRBAZ VECİZESİ
SÖYLEŞİ: HASBİHAL SÖZÜNÜN GÜNÜMÜZ TÜRKÇESİNDEKİ KARŞILIKLARINDAN BİRİ
PODYUM: ATLETİZM YARIŞMALARINDAN DERECE ALAN SPORCULARIN MADALYA ALDIKLARI MERDİVENLİ PLATFORMUN ADI
ÇEKECEK: TOPUK KAYDIRACI, KERATA
EŞEKBAŞI: OTORİTESİ ÖNEMSENMEYEN BİR KİŞİNİN, KENDİ YETKİSİNİ SORGULARKEN KULLANDIĞI SÖZ
MALİ: “FİNANSAL” SÖZÜNÜN EŞ ANLAMLISI
İPLEMEMEK: ARGODA DEĞER VE ÖNEM VERMEMEK, ALDIRIŞ ETMEMEK ANLAMINDAKİ SÖZ
ÇÖZÜMLEME: ANALİZ SÖZÜNÜN TÜRKÇE KÖKENLİ KARŞILIĞI
İPLEÇEKMEK: SABIRSIZLIKLA BEKLEMEK ANLAMINDAKİ DEYİM
SİLİK: MECAZİ ANLAMDA DİKKATİ ÇEKMEYEN, BELİRLİ OLMAYAN
EZGİ: MELODİ SÖZÜNÜN TÜRKÇE KÖKENLİ KARŞILIĞI
BATI: SİYASAL ANLAMDA AVRUPA VE KUZEY AMERİKA
NOKTA: SAYILARIN SONUNA GELDİĞİNDE SIRA BİLDİREN BİR İŞARET
KARTEL: TEKELCİ SERMAYE BİRLİĞİ
KARAGÖZ: BİR GÖLGE OYUNU KARAKTERİYLE ADAŞ OLAN İZMARİTGİLLERDEN BİR BALIK
ALERJİ: ÇEVRESEL ETKENLERE GÖSTERİLEN FİZYOLOJİK TEPKİ
GÜNEŞLİ: AYDINLIK, BULUTSUZ, AÇIK GÖKYÜZÜ VE HAVA DURUMUNU NİTELEMEK İÇİN KULLANILAN SÖZ
ÇATIŞMA: SİLAHLI ARBEDE
KIVIRMAK: MECAZİ ANLAMDA YALAN SÖYLEMEK, UYDURMAK
HAVAİFİŞEK: EĞLENCELİK UÇARI PATLAYICI
TABANFİYAT: RESMİ KURULUŞLARCA BELİRLENEN EN DÜŞÜK SATIŞ BEDELİ
HATIR: BİRİNE KARŞI DUYULAN SEVGİ, SAYGI
UNUFAK: TUTULAMAYACAK KADAR KÜÇÜK PARÇALARA AYRILMIŞ ANLAMINDA BİR SÖZ DİZİSİ
İMTİYAZ: BAŞKALARINA TANINMAYAN ÖZEL, KİŞİSEL HAK VE AYRICALIK
ADIBATSIN: BİRİNİN İSMİNE, KİMLİĞİNE BEDDUA ETMEK İÇİN KULLANILAN KALIPLAŞMIŞ TABİR
AZAP: BÜYÜK SIKINTI, EZİYET
HELE: CÜMLENİN BAŞINA KONARAK UYARMA, KORKUTMA VEYA VAAT ANLATAN BİR SÖZ
RASTGELE: SEÇMEDEN, İYİSİNİ KÖTÜSÜNÜ AYIRMADAN, GELİŞİGÜZEL
DEFNETMEK: TOPRAKTAN GELENİ TOPRAĞA GERİ VERMEK
DİZEGELMEK: YENİLMEK, PES ETMEK, BOYUN EĞMEK ANLAMLARINDA KULLANILAN BİR DEYİM
BEREKET: BOLLUK, GÜRLÜK, ONGUNLUK
ALELACELE: VAKİT GEÇİRMEDEN, ÇABUCAK ANLAMIDA BİR SÖZ